0011000000000000000
0111000000000000000
1111000000000000000
000P000111111111111
0000000100000000000
0000000000000000000
