0001000000000000000
000100000M00M00M000
0001000000000000000
000P000111111111111
0000000000000000000
0000000000000000000
