000100000M000000000
00000000M0000000000
000000000M000000000
0000000111111111111
0000000000000000000
0000011000P00000000
0000001000000000000
0000000001110000000
0000000000000000000
0000000000000000000
0000000000000000000
0000000000000000000
